kidval	CHILD	one	female
kidmin	CHILD	one	male
kidvalgal	CHILD	many	female
kidmingal	CHILD	many	male
sibval	SIBLING	one	female
sibmin	SIBLING	one	male
sibvalgal	SIBLING	many	female
sibmingal	SIBLING	many	male
pupval	STUDENT	one	female
pupmin	STUDENT	one	male
pupvalgal	STUDENT	many	female
pupmingal	STUDENT	many	male
lubval	BELOVED	one	female
lubmin	BELOVED	one	male
lubtu	BELOVED	one	thing
lubvalgal	BELOVED	many	female
lubmingal	BELOVED	many	male
lubtugal	BELOVED	many	thing
tutval	TEACHER	one	female
tutmin	TEACHER	one	male
tuttu	TEACHER	one	thing
tutvalgal	TEACHER	many	female
tutmingal	TEACHER	many	male
tuttugal	TEACHER	many	thing
doval	DOER	one	female
domin	DOER	one	male
dotu	DOER	one	thing
dovalgal	DOER	many	female
domingal	DOER	many	male
dotugal	DOER	many	thing
baltu	BALL	one	thing
baltugal	BALL	many	thing
tabltu	TABLE	one	thing
tabltugal	TABLE	many	thing
waltu	WALL	one	thing
waltugal	WALL	many	thing
hattu	HAT	one	thing
hattugal	HAT	many	thing
