kida	CHILD	one	female
kido	CHILD	one	male
kidaf	CHILD	two	female
kidof	CHILD	two	male
kidas	CHILD	many	female
kidos	CHILD	many	male
siba	SIBLING	one	female
sibo	SIBLING	one	male
sibaf	SIBLING	two	female
sibof	SIBLING	two	male
sibas	SIBLING	many	female
sibos	SIBLING	many	male
tuta	TEACHER	one	female
tuto	TEACHER	one	male
tutaf	TEACHER	two	female
tutof	TEACHER	two	male
tutas	TEACHER	many	female
tutos	TEACHER	many	male
pupa	STUDENT	one	female
pupo	STUDENT	one	male
pupaf	STUDENT	two	female
pupof	STUDENT	two	male
pupas	STUDENT	many	female
pupos	STUDENT	many	male
weda	WEDDINGPART	one	female
wedo	WEDDINGPART	one	male
wedaf	WEDDINGPART	two	female
wedof	WEDDINGPART	two	male
wedas	WEDDINGPART	many	female
wedos	WEDDINGPART	many	male
heda	BOSS	one	female
hedo	BOSS	one	male
hedaf	BOSS	two	female
hedof	BOSS	two	male
hedas	BOSS	many	female
hedos	BOSS	many	male
doka	DOCTOR	one	female
doko	DOCTOR	one	male
dokaf	DOCTOR	two	female
dokof	DOCTOR	two	male
dokas	DOCTOR	many	female
dokos	DOCTOR	many	male
tota	BABY	one	female
toto	BABY	one	male
totaf	BABY	two	female
totof	BABY	two	male
totas	BABY	many	female
totos	BABY	many	male
doga	DOG	one	female
dogo	DOG	one	male
dogaf	DOG	two	female
dogof	DOG	two	male
dogas	DOG	many	female
dogos	DOG	many	male
pona	HORSE	one	female
pono	HORSE	one	male
ponaf	HORSE	two	female
ponof	HORSE	two	male
ponas	HORSE	many	female
ponos	HORSE	many	male
