kida	CHILD	one	female
kido	CHILD	one	male
kidas	CHILD	many	female
kidos	CHILD	many	male
siba	SIBLING	one	female
sibo	SIBLING	one	male
sibas	SIBLING	many	female
sibos	SIBLING	many	male
tuta	TEACHER	one	female
tuto	TEACHER	one	male
tutas	TEACHER	many	female
tutos	TEACHER	many	male
frena	FRIEND	one	female
freno	FRIEND	one	male
frenas	FRIEND	many	female
frenos	FRIEND	many	male
girla	GIRL	one	female
boyo	BOY	one	male
girlas	GIRL	many	female
boyos	BOY	many	male
mama	MOTHER	one	female
dado	FATHER	one	male
mamas	MOTHER	many	female
dados	FATHER	many	male
bala	BALL	one
balas	BALL	many
tabla	TABLE	one
tablas	TABLE	many
walo	WALL	one
walos	WALL	many
hato	HAT	one
hatos	HAT	many
